tag	type
tccctattaa	ShortLinker
tccccgtaca	ShortLinker
tcccccgtac	ShortLinker
tcccctatta	ShortLinker
tccctattag	ShortLinker
tccccgtacc	ShortLinker
tccccgtact	ShortLinker
tccctattta	ShortLinker
tccccggtac	ShortLinker
tccccgtacg	ShortLinker
tccccgttac	ShortLinker
tcccgtacat	ShortLinker
tccctaatta	ShortLinker
tccctataag	ShortLinker
tccctattac	ShortLinker
tccctattat	ShortLinker
tccctattca	ShortLinker
tccctattga	ShortLinker
tcccttatta	ShortLinker
ttccccgtac	ShortLinker
ttccctatta	ShortLinker
accccgtaca	ShortLinker
accctattaa	ShortLinker
atccccgtac	ShortLinker
atccctatta	ShortLinker
cccccgtaca	ShortLinker
ccccgtacat	ShortLinker
cccctattaa	ShortLinker
ccctattaag	ShortLinker
ctccccgtac	ShortLinker
ctccctatta	ShortLinker
gccccgtaca	ShortLinker
gccctattaa	ShortLinker
gtccccgtac	ShortLinker
gtccctatta	ShortLinker
taccccgtac	ShortLinker
tacccgtaca	ShortLinker
taccctatta	ShortLinker
tactattaag	ShortLinker
tcacccgtac	ShortLinker
tcaccgtaca	ShortLinker
tcacctatta	ShortLinker
tcactattaa	ShortLinker
tccaccgtac	ShortLinker
tccacgtaca	ShortLinker
tccactatta	ShortLinker
tccatattaa	ShortLinker
tcccaattaa	ShortLinker
tcccacgtac	ShortLinker
tcccagtaca	ShortLinker
tcccatatta	ShortLinker
tcccattaag	ShortLinker
tccccagtac	ShortLinker
tccccataca	ShortLinker
tccccattaa	ShortLinker
tccccctaca	ShortLinker
tccccgaaca	ShortLinker
tccccgacat	ShortLinker
tccccgatac	ShortLinker
tccccgcaca	ShortLinker
tccccgctac	ShortLinker
tccccggaca	ShortLinker
tccccgtaaa	ShortLinker
tccccgtaac	ShortLinker
tccccgtaat	ShortLinker
tccccgtaga	ShortLinker
tccccgtagc	ShortLinker
tccccgtata	ShortLinker
tccccgtatc	ShortLinker
tccccgtcac	ShortLinker
tccccgtcat	ShortLinker
tccccgtcca	ShortLinker
tccccgtgac	ShortLinker
tccccgtgca	ShortLinker
tccccgttca	ShortLinker
tcccctacat	ShortLinker
tcccctgtac	ShortLinker
tccccttaca	ShortLinker
tcccgattaa	ShortLinker
tcccgcgtac	ShortLinker
tcccggtaca	ShortLinker
tcccgtatta	ShortLinker
tccctaataa	ShortLinker
tccctactaa	ShortLinker
tccctactta	ShortLinker
tccctagtaa	ShortLinker
tccctagtta	ShortLinker
tccctataaa	ShortLinker
tccctatata	ShortLinker
tccctatcaa	ShortLinker
tccctatcta	ShortLinker
tccctatgaa	ShortLinker
tccctatgta	ShortLinker
tccctcatta	ShortLinker
tccctcgtac	ShortLinker
tccctcttaa	ShortLinker
tccctgatta	ShortLinker
tccctgtaca	ShortLinker
tccctgttaa	ShortLinker
tccctttaag	ShortLinker
tcccttttaa	ShortLinker
tccgccgtac	ShortLinker
tccgcgtaca	ShortLinker
tccgctatta	ShortLinker
tccgtattaa	ShortLinker
tcctattaag	ShortLinker
tcctccgtac	ShortLinker
tcctcgtaca	ShortLinker
tcctctatta	ShortLinker
tccttattaa	ShortLinker
tcgcccgtac	ShortLinker
tcgccgtaca	ShortLinker
tcgcctatta	ShortLinker
tcgctattaa	ShortLinker
tctcccgtac	ShortLinker
tctccgtaca	ShortLinker
tctcctatta	ShortLinker
tctctattaa	ShortLinker
tgccccgtac	ShortLinker
tgcccgtaca	ShortLinker
tgccctatta	ShortLinker
tgcctattaa	ShortLinker
ttcccgtaca	ShortLinker
ttcctattaa	ShortLinker
aaacctccat	ShortRibosomal
aaaggtttgg	ShortRibosomal
aagtcggaat	ShortRibosomal
aattcccagt	ShortRibosomal
accagttgtt	ShortRibosomal
acctggttga	ShortRibosomal
agcgtgaatt	ShortRibosomal
atggatgaac	ShortRibosomal
cacgtgcctc	ShortRibosomal
cccggatagc	ShortRibosomal
cccggatgat	ShortRibosomal
cccggctagc	ShortRibosomal
ccgaaatagc	ShortRibosomal
ccgacgggcg	ShortRibosomal
cctcgttagc	ShortRibosomal
cgaatggcgg	ShortRibosomal
cgacgggcgc	ShortRibosomal
cgccctgatc	ShortRibosomal
cgctgtgatg	ShortRibosomal
ctaagtacgc	ShortRibosomal
ctacggccat	ShortRibosomal
ctcccgagtg	ShortRibosomal
cttaaagaaa	ShortRibosomal
cttaaagaag	ShortRibosomal
gaacagcagt	ShortRibosomal
gactcttaat	ShortRibosomal
gactcttagc	ShortRibosomal
gaggtgtaga	ShortRibosomal
gcagagtggc	ShortRibosomal
gcgacctcag	ShortRibosomal
gctcgttggt	ShortRibosomal
ggccagtggc	ShortRibosomal
gtaaagtcgt	ShortRibosomal
gtcagtcggt	ShortRibosomal
taagagttcg	ShortRibosomal
taagagttgg	ShortRibosomal
taatcctgct	ShortRibosomal
tcaagatatc	ShortRibosomal
tcccagagtc	ShortRibosomal
tcgaccagtt	ShortRibosomal
tcgacgccag	ShortRibosomal
tggaacaatg	ShortRibosomal
tgtaatggtt	ShortRibosomal
ttaaagaaag	ShortRibosomal
ttaaagaaga	ShortRibosomal
tttccgtagt	ShortRibosomal
caaacctcca	ShortMitochondrial
accaatgaac	ShortMitochondrial
aacggctaaa	ShortMitochondrial
aatatttcaa	ShortMitochondrial
acaaaaaatt	ShortMitochondrial
aggaggactt	ShortMitochondrial
aatatcacct	ShortMitochondrial
cttttgttat	ShortMitochondrial
caggagcatc	ShortMitochondrial
aaacccccag	ShortMitochondrial
tagttactta	ShortMitochondrial
agcaaaagcc	ShortMitochondrial
aaacactgtc	ShortMitochondrial
atctttataa	ShortMitochondrial
gctgccctcc	ShortMitochondrial
atcacacact	ShortMitochondrial
agcagtcccc	ShortMitochondrial
atttatcaca	ShortMitochondrial
aaccctaata	ShortMitochondrial
ataatacata	ShortMitochondrial
catatcacat	ShortMitochondrial
accattaact	ShortMitochondrial
atctaggagg	ShortMitochondrial
agctcatcat	ShortMitochondrial
gctactggat	ShortMitochondrial
taattattgg	ShortMitochondrial
atactgacat	ShortMitochondrial
agcaattcaa	ShortMitochondrial
taggaaccct	ShortMitochondrial
atctaacaac	ShortMitochondrial
cataatagca	ShortMitochondrial
ttgaagctcc	ShortMitochondrial
aagcttcata	ShortMitochondrial
gcctcacatc	ShortMitochondrial
gcccgaggac	ShortMitochondrial
atgactgata	ShortMitochondrial
gctttcttac	ShortMitochondrial
atcaattata	ShortMitochondrial
atatatacac	ShortMitochondrial
cttatcctca	ShortMitochondrial
agaacttcaa	ShortMitochondrial
actaccatca	ShortMitochondrial
cctagtaatc	ShortMitochondrial
atttttaaaa	ShortMitochondrial
aaaaatcatc	ShortMitochondrial
atgaaacttt	ShortMitochondrial
tcggacgagg	ShortMitochondrial
aggacaaata	ShortMitochondrial
tcttgatagt	ShortMitochondrial
aatattatct	ShortMitochondrial
accaacataa	ShortMitochondrial
catttggtat	ShortMitochondrial
aaaggacagc	ShortMitochondrial
cttgttagac	ShortMitochondrial
ttccgtgaac	ShortMitochondrial
tccctattaagcctagt	LongLinker
tccccgtacatcgttag	LongLinker
tcggatattaagcctag	LongLinker
gacgagcttaagttcga	LongLinker
aaacctccatagaccgg	LongRibosomal
aaaggtttggtcctggc	LongRibosomal
aagtcggaatccgctaa	LongRibosomal
aattcccagtaagtgcg	LongRibosomal
accagttgttcctttga	LongRibosomal
acctggttgatcctgcc	LongRibosomal
agcgtgaattgagtatg	LongRibosomal
atggatgaacgagattc	LongRibosomal
cacgtgcctcccgagtg	LongRibosomal
cccggatagctcagtcg	LongRibosomal
cccggatgatcctcagt	LongRibosomal
cccggctagctcagtcg	LongRibosomal
ccgaaatagctcagttg	LongRibosomal
ccgacgggcgctgaccc	LongRibosomal
cctcgttagcgcagtag	LongRibosomal
cgaatggcggccgctct	LongRibosomal
cgaatggcggccgttct	LongRibosomal
cgacgggcgctgacccc	LongRibosomal
cgccctgatcacgatat	LongRibosomal
cgctgtgatgatggatt	LongRibosomal
ctaagtacgcacggccg	LongRibosomal
ctacggccataccaccc	LongRibosomal
ctcccgagtgcatttct	LongRibosomal
cttaaagaaagaggtta	LongRibosomal
cttaaagaagaggttat	LongRibosomal
gactcttaatctcaggg	LongRibosomal
gactcttagcggtggat	LongRibosomal
gaggtgtagaataagtg	LongRibosomal
gcagagtggcgcagcgg	LongRibosomal
gcgacctcagatcagac	LongRibosomal
gctcgttggtctagggg	LongRibosomal
ggccagtggcgcaatgg	LongRibosomal
gtaaagtcgtaacaagg	LongRibosomal
gtcagtcggtcctgaga	LongRibosomal
taagagttcggttgcca	LongRibosomal
taagagttgggttccca	LongRibosomal
taatcctgctcagtacg	LongRibosomal
tcaagatatcgaggatc	LongRibosomal
tcccagagtcggtggat	LongRibosomal
tcgaccagttgttcctt	LongRibosomal
tcgacgccagttgttcc	LongRibosomal
tggaacaatgtaggtaa	LongRibosomal
tgtaatggttagcactc	LongRibosomal
ttaaagaaagaggttat	LongRibosomal
ttaaagaagaggttatg	LongRibosomal
tttccgtagtgtagtgg	LongRibosomal
caaacctccatagaccg	LongMitochondrial
accaatgaacactctga	LongMitochondrial
aacggctaaacgagggt	LongMitochondrial
aatatttcaacaacaaa	LongMitochondrial
acaaaaaattgctcccc	LongMitochondrial
aggaggacttaaccaaa	LongMitochondrial
aatatcaccttaagacc	LongMitochondrial
cttttgttataattttc	LongMitochondrial
caggagcatcagtagac	LongMitochondrial
aaacccccagccataac	LongMitochondrial
tagttacttactactcc	LongMitochondrial
agcaaaagcccacttcg	LongMitochondrial
aaacactgtctcttcta	LongMitochondrial
atctttataatttgaga	LongMitochondrial
gctgccctccaccatat	LongMitochondrial
atcacacactaataatt	LongMitochondrial
agcagtcccctccctag	LongMitochondrial
atttatcacaattatct	LongMitochondrial
aaccctaataattgttt	LongMitochondrial
ataatacataatgaccc	LongMitochondrial
catatcacatagttaat	LongMitochondrial
accattaactggagcct	LongMitochondrial
atctaggaggctgctga	LongMitochondrial
agctcatcatagcctta	LongMitochondrial
taattattggatcaaca	LongMitochondrial
atactgacattttgtag	LongMitochondrial
agcaattcaaacaatta	LongMitochondrial
taggaaccctaaacctc	LongMitochondrial
atctaacaacttactat	LongMitochondrial
cataatagcatttctta	LongMitochondrial
ttgaagctccaattgct	LongMitochondrial
aagcttcataggagcaa	LongMitochondrial
gcctcacatcatcactc	LongMitochondrial
gcccgaggacttcaaat	LongMitochondrial
atgactgatagcaagtc	LongMitochondrial
gctttcttacttttata	LongMitochondrial
atcaattatacaattct	LongMitochondrial
atatatacactcagacc	LongMitochondrial
cttatcctcacctcagc	LongMitochondrial
agaacttcaacagatta	LongMitochondrial
actaccatcagcaatag	LongMitochondrial
cctagtaatcggaagcc	LongMitochondrial
atttttaaaaaccacag	LongMitochondrial
aaaaatcatcgttgtaa	LongMitochondrial
atgaaactttgggtccc	LongMitochondrial
tcggacgaggcttatat	LongMitochondrial
aggacaaatatcattct	LongMitochondrial
tcttgatagtataaaca	LongMitochondrial
aatattatcttaaacac	LongMitochondrial
accaacataactgtggt	LongMitochondrial
catttggtatcttttta	LongMitochondrial
aaaggacagcacacagt	LongMitochondrial
cttgttagacataaatg	LongMitochondrial
ttccgtgaaccaaaact	LongMitochondrial
